............
.##########.
.#.##...#...
.#..#...#...
.#..###.#...
......#.#...
..###...#...
..#.....##..
........#...
........#...
....##..#...
..........#.

